111111111111111111111111111111
1P0000C00C0C0000C0C00CCCCCCCC1
10111111111111000000001110CCC1
10000000000000000011000C0000C1
10000000000000000011000000C0C1
1000000000010C00000001000000C1
1011111100011101100001001000C1
1000000000000000000001111100C1
1011111100001000000001000000C1
101EC00100001000000000000000C1
1010000100001001111111100000C1
10100001000CCCCCCCCCCCCCCCCCC1
10100001000C100111111110000001
1000000CCCCC100CC0CC0000000001
100000110000100110000110000001
100000110000100000000000000001
100000000000100000000000000001
111111111111111111111111111001
101010101010111111111111111111
111111111111111111111111111111