111111111111
100000000E01
1100C1111111
101000P00011
100C00000101
111111111111