111111111111
10E000000001
1000C0000001
100C00000P01
100C00000001
111111111111