11111111111
100000EC001
1C0000CC001
1C0000C0001
1C0000P00C1
1C0000CC001
1C0000C00C1
11111111111