111111111111111111111111111111111111111111111111111111111111111111111111111111111111111111
100010000000001111000011000011110000110000111100001100001111000011000011110000110000111101
100000000000001111000011000011110000110000111100001100001111000011000011110000110000111101
111100011100011110000110000111100001100001111000011000011110000110000111100001100001111001
100000000000000000111000011110000110000111100001100001111000011000011110000110000111100001
100P000001111111000000000000000001111000011111100000C0000000000011110000111111000000000001
11C000C111111111000000000011111111111100000000C0000000011110000111111000000000000000001111
1000000000000000000000000000000000000000000000011110000C0000000000001111000011111100000001
100000000000000000000000000001111000011111000001111000011110000011110000111110000011110001
100011110000111110000011110000111110000011110000111110011111111111100011110000111110000011
1000000000000000000000000001111000011000000000000000000C0000000001111000011111000001111001
100011110000111110000011110000111110000011110000111110011111111111100011110000111110000011
100000000000000000000000000111100001111100001111100000000000000000111100001111111110000111
1000000000C0000000000000000001111000011111000001111000011110000011110000111110000011110001
100000000000000000000000111111111111111111110001111000011110000011110000111110000011110001
100011110000111110000011110000111110000011110000111110011111111111100011110000111110000011
100000000000000000000000000111100001100000000000000000000000E00001111000011111000001111001
111111111111111111111000011111111111111111111111111111111111111111111100000111111111111111
111110000111111111C00011111111100001111100000000000000000111100001111100000111000000000001
100000000000000000000001111000011111111100001111100000000000000000111100001111111110000111
100000000000000000000000000001111000011111000001111000011110000011110000111110000011110001
100011110000111110000011110000111110000011110000111110011111111111100011110000111110000011
100000000000000000000000000111100001111100000111100001111100000111100001111100000111100001
100011110000111000000000111110001111000011100000000011111000111100001110000000001111100011
111111111100000000000011110000111000000000111110001111000011100000000011111000111100001111
111111111111111111111111111111111111111111111111111111111111111111111111111111111111111111