111111111111
10E100000001
1100C1111111
101P00000011
100C00000101
111111111111